9 22
. . @ @ @ @ . . . @ @ @ @ . . . @ @ @ @ . .
. . . . . . . @ . . . . . . @ . . . . . . .
. . @ @ @ @ . @ . @ @ @ @ . @ . @ @ @ @ . .
. . . . . . . @ . . . . . . @ . . . . . . .
. . @ @ @ @ . . . @ @ @ @ . . . @ @ @ @ . .
. . . . . . . @ . . . . . . @ . . . . . . .
. . @ @ @ @ . @ . @ @ @ @ . @ . @ @ @ @ . .
. . . . . . . @ . . . . . . @ . . . . . . .
. . @ @ @ @ . . . @ @ @ @ . . . @ @ @ @ . .
6
3 0 8 20
5 0 6 20
7 1 5 21
5 1 5 20
0 0 0 21
7 0 3 21